brain	sexGYBQ	F
GYLB	F
GYLD	F
GYLE	F
GYLF	F
GYLG	F
GYLK	F
GYLM	F
GYLN	F
GYLQ	F
GYLT	F
GYLU	F
GYLX	F
GYLZ	F
GYMb	M
GYMB	M
GYMF	M
GYMH	M
GYMP	M
GYMQ	M
GYMS	M
GYHS	M
GYAG	M
GYKA	M
GYKD	M
GYKE	M